WE srcs/xpm/west.xpm
SO srcs/xpm/south.xpm
EA srcs/xpm/east.xpm
NO srcs/xpm/north.xpm
D  textures/copper.xpm


C 135,206,235
F 119,136,153


111111111111111111111111111111
100000000000000000000000000001
100000000000000000000000000001
100000000N00000000000000000001
100000000000000000000000000001
100000000000000000000000000001
100000000000000000000000000001
100000111110000101010000000001
100000100010000000000000000001
100000100010000100010000000001
100000100010000000000000000001
100000111100001010100000000001
100000000000000000000000000001
100000000000000000000000000001
100000000000000000000000000001
100000000000000000000000000001
100000000000000000000000000001
100000000000000000000000000001
100000000000000000000000000001
111111111000000000000000000001
100100001000000000000000000001
100000101000000000000000000001
100100001000000000000000000001
100111111000000000000000000001
100000000000000000000000000001
100000000000000000000000000001
111111111111111111111111111111