NO maps/xpm/METALTILE.xpm
SO maps/xpm/METALTILE.xpm
WE maps/xpm/METALTILE.xpm
EA maps/xpm/METALTILE.xpm
F 153,146,161
D  maps/xpm/techwall.xpm
C 64,62,66




         11111111111111111111111
        1000000000110000000000001
        1011000001110000000000001
        1001000000200000000000001
111111111011000001110000000000001
100000000011000001112111112111111
11110111111111011100000010001
11112111111111211101010010001
11000000110101011100000010001
10000000000000001100000010001
10000000000000001101010010001
11000001110101011111011210N0111
11110111 1110101 101111020001
11111111 1111111 111111111111







