NO ./textures/copper.xpm
EA ./textures/chiseled_sb.xpm
SO ./textures/stone.xpm
WE ./textures/purpur.xpm
D  ./textures/door.xpm 

C 66,135,245
F 109,135,112

        1111111111111111111111111
        1000000000110000000000001
   1    1001100000111000000001001
  101   1002000000000000000000001
111011111011000001110000000000001
110000000000000001111111111111111
11112111111111011100000010001
11110111100111011101010010001
11000000110101011100000010001                       
1000S000000000000200000020001
10000000000000000101010010001           
11000001110101011111011110001
11110111 1110101 101111010001
11111111 1111111 111111111111
