
NO ./textures/wall.xpm
EA ./textures/east.xpm
SO ./textures/chiseled_sb.xpm
WE ./textures/chiseled_sb.xpm

C 166,135,145
F 255,0,0

        111111111111111111111111
        1000000000110000000000001
   1    1001100000111000000001001
  101   1001000000000000000000001
1110111110110000011100N0000000001
110000000000000001111111111111111
11111111111111011100000010001
11110111100111011101010010001
11000000110101011100000010001 
11111111111111111111111111111





